{
    "name": "Classic",
    "tileSize": 30.0,
    "maxPlayers": 4,
    "tiles": [
        "############################",
        "#............##............#",
        "#.####.#####.##.#####.####.#",
        "#o####.#####.##.#####.####o#",
        "#.####.#####.##.#####.####.#",
        "#..........................#",
        "#.####.##.########.##.####.#",
        "#.####.##.########.##.####.#",
        "#......##....##....##......#",
        "######.##### ## #####.######",
        "######.##### ## #####.######",
        "###### ##          ## ######",
        "###### ## ####G### ## ######",
        "###### ## #      # ## ######",
        "######.   #      #   .######",
        "###### ## #      # ## ######",
        "###### ## ######## ## ######",
        "######.##..........##.######",
        "######.## ######## ##.######",
        "######.## ######## ##.######",
        "#............##............#",
        "#.####.#####.##.#####.####.#",
        "#.####.#####.##.#####.####.#",
        "#o..##.......  .......##..o#",
        "###.##.##.########.##.##.###",
        "###.##.##.########.##.##.###",
        "#......##....##....##......#",
        "#.##########.##.##########.#",
        "#.##########.##.##########.#",
        "#..........................#",
        "############################"
    ],
    "pacmanSpawns": [
        {
            "pos": [
                12,
                23
            ]
        },
        {
            "pos": [
                15,
                23
            ]
        },
        {
            "pos": [
                12,
                26
            ]
        },
        {
            "pos": [
                15,
                26
            ]
        }
    ],
    "ghostSpawns": {
        "blinky": {
            "pos": [
                13,
                14
            ]
        },
        "pinky": {
            "pos": [
                14,
                14
            ]
        },
        "inky": {
            "pos": [
                13,
                15
            ]
        },
        "clyde": {
            "pos": [
                14,
                15
            ]
        }
    }
}