{
    "name": "Classic",
    "tileSize": 32.0,
    "maxPlayers": 4,
    "tiles": [
        "###################",
        "#........#........#",
        "#.##.###.#.###.##.#",
        "#o##.###.#.###.##o#",
        "#.##.###.#.###.##.#",
        "#.................#",
        "#.##.#.#####.#.##.#",
        "#.##.#.#####.#.##.#",
        "#....#...#...#....#",
        "####.###.#.###.####",
        "####.#.......#.####",
        "####.#.#GGG#.#.####",
        "####.#.#   #.#.####",
        "####.#.#####.#.####",
        "####.........#.####",
        "####.#.#####.#.####",
        "####.#.......#.####",
        "#........#........#",
        "#.##.###.#.###.##.#",
        "#o..#....P....#..o#",
        "#...#.#.###.#.#...#",
        "#....#...#...#....#",
        "#.######.#.######.#",
        "#.................#",
        "#.................#",
        "###################"
    ],
    "pacmanSpawns": [
        {"pos": [9,  19]},
        {"pos": [1,  23]},
        {"pos": [17, 23]},
        {"pos": [9,  24]}
    ],
    "ghostSpawns": {
        "blinky": {"pos": [9,  11]},
        "pinky":  {"pos": [8,  11]},
        "inky":   {"pos": [10, 11]},
        "clyde":  {"pos": [9,  10]}
    }
}
